E..........##
####.a..b.###
..........###
.#####.a....#
.........b..S