E..........##
##########.##
...........##
.############
............S